!_TAG_FILE_SORTED	1	/0=unsorted, 1=sorted/
contains	source.kt	/^    operator fun contains(other: Counter) = other.value == this.value$/;"	
even	source.kt	/^    fun even(x: Int) = x % 2 == 0$/;"	
fibonacciSequence	source.kt	/^    fun fibonacciSequence(): Sequence<Long> {$/;"	
hello	source.kt	/^    fun hello(name: String = "world"): String {$/;"	
hello	source.kt	/^    fun hello(): String {$/;"	
inc	source.kt	/^    operator fun inc() = Counter(value + 1)$/;"	
infixMemberFunction	source.kt	/^        infix fun infixMemberFunction(y: Int): Int {$/;"	
invoke	source.kt	/^    operator fun invoke() = println("The value of the counter is $value")$/;"	
main	source.kt	/^fun main(args: Array<String>) {$/;"	
memberFunction	source.kt	/^        fun memberFunction(y: Int): Int {$/;"	
next	source.kt	/^        fun next(): Long {$/;"	
not	source.kt	/^    fun not(f: (Int) -> Boolean): (Int) -> Boolean {$/;"	
odd	source.kt	/^    fun odd(x: Int): Boolean = x % 2 == 1$/;"	
operatorOverloadingDemo	source.kt	/^fun operatorOverloadingDemo() {$/;"	
plus	source.kt	/^    operator fun plus(other: Counter) = Counter(this.value + other.value)$/;"	
plusAssign	source.kt	/^    operator fun plusAssign(increment: Int) {$/;"	
printEnum	source.kt	/^fun printEnum() = println(EnumExample.A) \/\/ => A$/;"	
printName	source.kt	/^fun printName() = println(EnumExample.A.name) \/\/ => A$/;"	
printPosition	source.kt	/^fun printPosition() = println(EnumExample.A.ordinal) \/\/ => 0$/;"	
printProperty	source.kt	/^fun printProperty() = println(EnumExample.A.value) \/\/ => 1$/;"	
remove	source.kt	/^    fun String.remove(c: Char): String {$/;"	
set	source.kt	/^    operator fun set(index: Int, value: Int) {$/;"	
smartCastExample	source.kt	/^    fun smartCastExample(x: Any) : Boolean {$/;"	
smartCastWhenExample	source.kt	/^    fun smartCastWhenExample(x: Any) = when (x) {$/;"	
times	source.kt	/^    operator fun times(other: Counter) = Counter(this.value * other.value)$/;"	
times	source.kt	/^    operator fun times(value: Int) = Counter(this.value * value)$/;"	
toString	source.kt	/^    override fun toString(): String {$/;"	
unaryMinus	source.kt	/^operator fun Counter.unaryMinus() = Counter(-this.value)$/;"	
useSingletonObject	source.kt	/^fun useSingletonObject() {$/;"	
varargExample	source.kt	/^    fun varargExample(vararg names: Int) {$/;"	
